########################################
#.................#....................#
#.....########....#....................#
#.....#...........#..#.................#
#.....#..#######..#..#.................#
#.....#...........#..#..####...........#
#..####...........#..#..#..#...........#
#..#....#######...#..#..#..#...........#
#..#..........#......#..#..#...........#
#..#..#####...#......#.....#...........#
#..#..#.......#......#..#..#...........#
#..#..#...########################..####
#..#..#...#...#.....................#..#
#..#..#...#...#...#..############...#..#
#.....#...#...#...#..#..............#..#
#######...#...#...#..#....###########..#
#.........#...#...#..#.................#
#...#######...#...#..####....###########
#...#.........#...#..#.................#
#...#.........#...#..#.......#...#.....#
#...#.........#...#..#.......#...#.#####
#...#.........#...#..#.......#...#.....#
#...#...#######...#..#.......#...#####.#
#....................#.......#...#.....#
###...################.......#...#.#####
#............................#...#.....#
#....#########....############...#.....#
#............#....#..............#.....#
#...#######..#....#......#########.....#
#............#....#.#......#.......#####
#............#....#.######.#...#####...#
#.#########..#....#.#......#...........#
#.................#.#......#####.......#
#.....#############.#......#.....#.....#
#.....#.............#..#####.....#.....#
#.....#.............#......#.....#.....#
#.....#.............#...#######..#.....#
#.....###########...#............#.....#
#...................#......#.....#.....#
########################################
